R 640 480
NO ./texture/bluestone.XPM
SO ./texture/colorstone.XPM
WE ./texture/greystone.XPM
EA ./texture/mossy.XPM

S ./texture/barrel.XPM
F 132, 148, 250
C 150, 82, 3

        1111111111111112111111111
        1000000000110000000000001
        1011000001110000002000002
  0     1001000000000000000000001
111111111011000001110000000000001
10000000001100000111111111111111
11110111111111011100000010001
11110111111111011101010000001
11000000110101011100000010001
10002000000000000000000011111
1000000000000000110101N00001
1100000111010101111001111000111
11111111 1110101010011010001
1111 111 1111111 111111111111