R 640 480
NO ./texture/bluestone.XPM
SO ./texture/colorstone.XPM
WE ./texture/greystone.XPM
EA ./texture/mossy.XPM

S ./texture/barrel.XPM
F 132, 148, 250
C 150, 82, 3

        1 1 1 1 1 1 1 1 1 1 1 1 1 1 1 1 1 1
        1 0 0 0 0 0 0 0 0 0 0 0 0 0 0 0 1
        1 1 1 1 0 0 0 0 0 0 0 0 1 1 1 1 1
        1 0 0 0 0 0 0 0 0 0 0 0 0 0 0 2 1
        1 1 1 1 0 0 0 0 0 0 0 0 1 1 1 1 1
1 1 1 1 1 0 0 2 0 0 0 0 0 0 0 0 1
1 0 0 0 0 0 0 0 0 0 0 0 0 2 0 0 1
1 2 0 0 0 0 0 0 0 0 0 0 0 0 0 0 1 1
1             0                 1
1 0 0 0 0 0 0 0 0 0 0 0 0 0 0 0 1 1
1 0 0 0 0 0 2 0 0 0 0 1 1 1 0 0 1 1
1 0 0 0 0 0 0 0 0 0 0 0 0 0 0 0 1
1 0 0 0 0 0 0 0 0 0 0 N 0 0 0 2 1
1 1 1 1 1 1 2 0 0 1 1 1 1 1 1 1 1
1 1 1   1 1 0 0 2 1 1 1   1 1 1 1
1 1 1   1 1 1 1 1 1 1 1   1 1 1 1
