R 640 480
NO ./texture/bluestone.XPM
SO ./texture/colorstone.XPM
WE ./texture/greystone.XPM
EA ./texture/mossy.XPM

S ./texture/barrel.XPM
F 132, 148, 250
C 150, 82, 3

        111111111111111111111111111111111
        100000000000000000000000000000021
        100000000000000000000000111111111
111111111000000000000000000000001
100000000000000000000000000000001
100000000200000000000000000000001
111111111000000000000000000000001
100000000000000000020000000000001
100000000000000000000000000000001
100000000000000000000000000000001
100000000002000111111200000000001
12000000000000011111100000W000001
100000000000000000000200000000001
100000000000000000000000000000001
100000000000000000000000000000001
101111110000000001110000000000001111
101 11010000000021 10000000000001
111 11111111111111 11111111111111
