R 1000 900
NO ./texture/bluestone.XPM
SO ./texture/colorstone.XPM
WE ./texture/greystone.XPM
EA ./texture/mossy.XPM

S ./texture/barrel.XPM
F 132, 148, 250
C 150, 82, 3

11111111111111111111111111111111
100000000020010000000001   100001
100000020000010000001001   100001
11111110000000000011111    1100011
10002000000000000011       1110001
1000000000111111001          10001
1111110000000000011        11110011   
1111000000000000001      100000001
   11000000000000011     100000111     1111111111111111111111111111111111
11100000000000000011     1100000001    1000000000000000000000000000000001
  10000000000000001111111000001111      11000000001111111111111111111111111
  1000000000000000000000000001          10000001
111000000000000000000000000001          10001111
1000000000000S0000000000000001          10001
100000000000000000000000000000111       110001
10000000000000000000000000000001     11110111
100000000000000000002000000000001     100111
100000000000000000020000000000001111110001
1110000000000000000220000000000000000000001
   1000000000000000000000000000000000011111
    1111111111111111111111111111111111111
