R 640 480
NO ./texture/bluestone.XPM
SO ./texture/colorstone.XPM
WE ./texture/greystone.XPM
EA ./texture/mossy.XPM

S ./texture/barrel.XPM
F 132, 148, 250
C 150, 82, 3

        11111111111111111111111111111111
        100000000000000000000000000000021
        10000000000000000000000011111111111
11111111100000000000000000000000111
10000000000000000000000000000000111
10000000020000000000000000000001111
111111111000000000200000000000001
10000000000000000002000000001111
1000000000000000000000000000000011111
10000000000000000000000000000111
100000000002000111111200000000001111
1200000000000001120000000W0000111
1000000000000001111112000000011111                    111111111
10000000000000000000000000000011111111                100000001
1000000000000000000000000000000011                    100000001
101111110000000001110000000000001111111111111111111111100000001
101 11010000000001 10000000000000000000000000000000000000000001
111 11111111111111 11111111111111111111111111111111111111111111
