R 640 480
NO ./texture/bluestone.XPM
SO ./texture/colorstone.XPM
WE ./texture/greystone.XPM
EA ./texture/mossy.XPM

S ./texture/barrel.XPM
F  132, 148, 250
C 150, 82, 3

1111111111111000000000000
1S00000000000
10000000022001
10000000000001
10000000000001
10020000020001
10000000000001
11111111111111
