R 640 480
NO ./texture/bluestone.XPM
SO ./texture/colorstone.XPM
WE ./texture/greystone.XPM
EA ./texture/mossy.XPM

S ./texture/barrel.XPM
F  132, 148, 250
C 150, 82, 3

11111111111111
10000000000001
10020000020001111
1000000    0000001000000000
10000000000001111
10020000020001
1N000000000001
11111111111111