R 640 480
NO ./texture/bluestone.XPM
SO ./texture/colorstone.XPM
WE ./texture/greystone.XPM
EA ./texture/mossy.XPM

S ./texture/barrel.XPM
F 132, 148, 250
C 150, 82, 3

    0    111111111111111111111111111
1  0    11000000000111000000000001
        1001100000111000000200000011111111
        11001000000000000000000001
111111111011000001110000000000001111111111
100000000011000001110001111111111111
11110111111111011100000010001111
1111011111111101110101001000111
1110000110101011100000012001111111111
1002011100000000000000000000000001111
1100000010010001110101001000111111111
11100001 10101011101101111N00001
11110101 1010101 10011110110010111
11111111 1111111 11111111111111111