R 640 480
NO ./texture/bluestone.XPM
SO ./texture/colorstone.XPM
WE ./texture/greystone.XPM
EA ./texture/mossy.XPM

S ./texture/barrel.XPM
F 132, 148, 250
C 150, 82, 3

        111111111111111111111111111000000100
000000001000000000111000000000001
00000000100110000011100000020000011111100000000000
00000000110010000000000000000000011111111
11111111110110000011100000000000011
1000000000110000011101111111111111111
11110111111111011100000010001
1111011111111101110101001000111
1100000110101011100000012001111111
1002011100200000000000110000000001111
1100000000010001110101001000111111
11100001110101011111101111N00111
11110111 1110101 1011110110010111
11111111 1111111 11111111111 111110000000